no,name,kor,eng,math,total,avg,rank,c_date
1,Croux,100,78,87,265,88,0,2024-04-05
2,Burtonwood,74,61,95,230,76,0,2024-04-01
3,Dallyn,86,77,63,226,75,0,2024-04-01
4,Brockington,71,67,65,203,67,0,2024-04-08
5,Bonelle,70,76,99,245,81,0,2024-04-06
6,Foyston,76,64,57,197,65,0,2024-04-06
7,Pearson,63,92,51,206,68,0,2024-04-05
8,Marron,61,81,90,232,77,0,2024-04-02
9,Bear,87,62,95,244,81,0,2024-04-06
10,Klassmann,88,99,89,276,92,0,2024-04-05
11,Wilding,95,84,82,261,87,0,2024-04-04
12,Ogglebie,75,81,67,223,74,0,2024-04-07
13,Alder,74,52,92,218,72,0,2024-04-01
14,Doumic,83,90,85,258,86,0,2024-04-09
15,MacConchie,79,83,76,238,79,0,2024-04-04
16,Larrosa,54,77,62,193,64,0,2024-04-04
17,Wooding,95,72,94,261,87,0,2024-04-05
18,Kaplin,60,100,63,223,74,0,2024-04-03
19,Kirsop,93,99,56,248,82,0,2024-04-07
20,Pedwell,70,100,64,234,78,0,2024-04-09
21,Gerriets,66,84,91,241,80,0,2024-04-01
22,Massingham,54,92,71,217,72,0,2024-04-04
23,Gilardi,73,93,97,263,87,0,2024-04-01
24,Spaxman,99,52,97,248,82,0,2024-04-03
25,Hellin,67,88,97,252,84,0,2024-04-08
26,Rankcom,73,88,96,257,85,0,2024-04-09
27,Pogson,95,61,78,234,78,0,2024-04-09
28,Artindale,58,73,73,204,68,0,2024-04-04
29,Millgate,85,75,61,221,73,0,2024-04-03
30,Standish,76,91,80,247,82,0,2024-04-04
31,Duplan,53,79,63,195,65,0,2024-04-02
32,Simounet,100,78,99,277,92,0,2024-04-01
33,Chastand,89,89,96,274,91,0,2024-04-03
34,Creavan,80,85,55,220,73,0,2024-04-09
35,Hobbert,67,67,74,208,69,0,2024-04-09
36,Vest,64,67,75,206,68,0,2024-04-06
37,Stidworthy,51,60,75,186,62,0,2024-04-05
38,Mulqueen,75,60,70,205,68,0,2024-04-02
39,Inworth,51,59,94,204,68,0,2024-04-03
40,Hebner,63,82,98,243,81,0,2024-04-02
41,Crayden,83,80,57,220,73,0,2024-04-05
42,Lucus,95,87,50,232,77,0,2024-04-07
43,Ottam,87,94,97,278,92,0,2024-04-06
44,Lutsch,59,83,92,234,78,0,2024-04-03
45,Parram,57,69,55,181,60,0,2024-04-07
46,Harken,53,62,85,200,66,0,2024-04-09
47,Vobes,75,60,55,190,63,0,2024-04-08
48,Muston,56,86,72,214,71,0,2024-04-01
49,Rickerby,92,87,61,240,80,0,2024-04-04
50,Sorensen,80,76,55,211,70,0,2024-04-08
51,Segar,64,80,68,212,70,0,2024-04-01
52,Brydie,69,62,75,206,68,0,2024-04-08
53,Burk,87,70,83,240,80,0,2024-04-06
54,Ridolfi,50,56,84,190,63,0,2024-04-09
55,Hallahan,59,53,53,165,55,0,2024-04-07
56,Cardozo,75,86,59,220,73,0,2024-04-07
57,Gatchell,93,84,67,244,81,0,2024-04-04
58,Damper,71,78,80,229,76,0,2024-04-03
59,Costy,98,53,77,228,76,0,2024-04-02
60,Dwight,96,95,71,262,87,0,2024-04-06
61,Vazquez,93,55,84,232,77,0,2024-04-06
62,Barsby,65,81,88,234,78,0,2024-04-05
63,Rash,54,82,97,233,77,0,2024-04-01
64,Aldis,93,55,76,224,74,0,2024-04-03
65,Isgar,89,50,88,227,75,0,2024-04-07
66,Cubin,94,85,78,257,85,0,2024-04-01
67,McInility,90,67,94,251,83,0,2024-04-02
68,Stennett,61,100,86,247,82,0,2024-04-08
69,Bau,96,86,97,279,93,0,2024-04-03
70,Mathivet,51,82,77,210,70,0,2024-04-04
71,Tandy,76,91,82,249,83,0,2024-04-05
72,Muddimer,97,55,89,241,80,0,2024-04-02
73,Appleby,77,63,69,209,69,0,2024-04-02
74,Bonnette,65,66,69,200,66,0,2024-04-03
75,Pilpovic,71,80,70,221,73,0,2024-04-06
76,Barnwille,77,68,80,225,75,0,2024-04-05
77,Curedell,65,99,80,244,81,0,2024-04-01
78,Brownlea,61,95,84,240,80,0,2024-04-06
79,Ferber,63,83,89,235,78,0,2024-04-07
80,Toleman,67,65,98,230,76,0,2024-04-09
81,Baraja,72,57,53,182,60,0,2024-04-03
82,Janzen,57,54,83,194,64,0,2024-04-04
83,Skellorne,70,68,56,194,64,0,2024-04-02
84,Hinkins,95,94,98,287,95,0,2024-04-02
85,Plowell,54,74,68,196,65,0,2024-04-03
86,Daoust,98,55,97,250,83,0,2024-04-07
87,Hext,60,95,92,247,82,0,2024-04-06
88,Vaneev,63,82,76,221,73,0,2024-04-05
89,Checcuzzi,94,78,58,230,76,0,2024-04-08
90,Radsdale,56,52,78,186,62,0,2024-04-01
91,Blaise,72,83,71,226,75,0,2024-04-07
92,Dobbison,82,72,65,219,73,0,2024-04-05
93,Josskovitz,63,75,98,236,78,0,2024-04-07
94,Effnert,100,66,55,221,73,0,2024-04-02
95,Fazan,70,62,93,225,75,0,2024-04-05
96,Godin,52,57,68,177,59,0,2024-04-02
97,Goodlip,76,92,55,223,74,0,2024-04-04
98,Wiggam,98,66,54,218,72,0,2024-04-07
99,Brantzen,89,50,88,227,75,0,2024-04-04
100,McMinn,90,69,53,212,70,0,2024-04-04
101,Jepensen,89,84,52,225,75,0,2024-04-04
102,Ramble,90,92,56,238,79,0,2024-04-09
103,Loughhead,53,72,92,217,72,0,2024-04-05
104,Ferrarin,69,72,54,195,65,0,2024-04-03
105,Cortese,67,78,51,196,65,0,2024-04-05
106,Offield,81,60,67,208,69,0,2024-04-05
107,Franiak,75,56,70,201,67,0,2024-04-09
108,Bluschke,99,60,75,234,78,0,2024-04-06
109,Beernaert,66,55,96,217,72,0,2024-04-06
110,Renvoys,88,80,91,259,86,0,2024-04-02
111,McGaffey,80,52,99,231,77,0,2024-04-02
112,Conan,54,62,72,188,62,0,2024-04-08
113,Renols,94,63,98,255,85,0,2024-04-06
114,Meacher,92,55,70,217,72,0,2024-04-01
115,Duggon,65,64,66,195,65,0,2024-04-03
116,Simoni,88,51,97,236,78,0,2024-04-07
117,Notti,76,62,69,207,69,0,2024-04-07
118,Furzey,70,72,91,233,77,0,2024-04-07
119,Hartwell,66,65,72,203,67,0,2024-04-09
120,Puttrell,84,81,92,257,85,0,2024-04-04
121,Counter,74,61,80,215,71,0,2024-04-07
122,Sudworth,94,51,91,236,78,0,2024-04-03
123,Tinsley,55,88,60,203,67,0,2024-04-07
124,Huffa,76,87,54,217,72,0,2024-04-04
125,Whittek,73,60,63,196,65,0,2024-04-09
126,Tapley,70,59,87,216,72,0,2024-04-04
127,Prettyjohns,58,88,81,227,75,0,2024-04-05
128,Beuscher,67,93,73,233,77,0,2024-04-02
129,Ellicock,76,84,92,252,84,0,2024-04-03
130,Bilbie,90,86,51,227,75,0,2024-04-01
131,Crabtree,78,76,84,238,79,0,2024-04-02
132,Pilbury,86,52,65,203,67,0,2024-04-03
133,Loynes,83,84,93,260,86,0,2024-04-01
134,Stolberger,98,60,100,258,86,0,2024-04-09
135,Frame,54,92,60,206,68,0,2024-04-08
136,Kyllford,78,79,69,226,75,0,2024-04-09
137,McTrustie,69,63,60,192,64,0,2024-04-08
138,Holyland,97,62,98,257,85,0,2024-04-06
139,Birrane,78,81,73,232,77,0,2024-04-04
140,Gershom,65,67,74,206,68,0,2024-04-06
141,Jorry,60,66,98,224,74,0,2024-04-01
142,Boothe,67,86,83,236,78,0,2024-04-05
143,Leverson,83,72,67,222,74,0,2024-04-04
144,Blaksland,50,59,77,186,62,0,2024-04-02
145,Segar,98,56,65,219,73,0,2024-04-07
146,Sloat,62,95,57,214,71,0,2024-04-08
147,Wilprecht,95,62,91,248,82,0,2024-04-06
148,Prinnett,69,82,64,215,71,0,2024-04-06
149,Denver,82,84,73,239,79,0,2024-04-01
150,Ayrs,92,81,95,268,89,0,2024-04-07
151,Jerome,63,88,92,243,81,0,2024-04-03
152,Cattrall,74,54,93,221,73,0,2024-04-01
153,Fonso,84,85,53,222,74,0,2024-04-08
154,Canny,50,71,79,200,66,0,2024-04-08
155,Langrish,78,75,81,234,78,0,2024-04-03
156,Ransom,79,87,63,229,76,0,2024-04-06
157,Philippeaux,99,74,86,259,86,0,2024-04-09
158,Diment,55,50,93,198,66,0,2024-04-05
159,Sommerlie,70,96,60,226,75,0,2024-04-08
160,Thebeau,90,92,86,268,89,0,2024-04-02
161,Mustoe,79,93,87,259,86,0,2024-04-08
162,Dyde,52,51,97,200,66,0,2024-04-06
163,Burbridge,63,88,97,248,82,0,2024-04-04
164,Smissen,95,54,61,210,70,0,2024-04-05
165,Blaskett,57,96,65,218,72,0,2024-04-05
166,Janku,73,91,78,242,80,0,2024-04-04
167,Lodo,51,82,83,216,72,0,2024-04-06
168,Warbys,72,50,74,196,65,0,2024-04-08
169,Vanderplas,75,82,64,221,73,0,2024-04-03
170,Eydel,80,58,61,199,66,0,2024-04-02
171,Jennings,76,50,56,182,60,0,2024-04-05
172,Figgins,66,52,72,190,63,0,2024-04-09
173,Paradise,55,81,77,213,71,0,2024-04-07
174,Bleyman,66,90,94,250,83,0,2024-04-04
175,Mc Andrew,68,56,92,216,72,0,2024-04-06
176,Sickling,84,52,65,201,67,0,2024-04-07
177,Conley,88,65,50,203,67,0,2024-04-08
178,Cawkill,76,95,53,224,74,0,2024-04-03
179,Howgate,73,93,95,261,87,0,2024-04-06
180,Breyt,84,89,56,229,76,0,2024-04-05
181,Penning,92,87,63,242,80,0,2024-04-01
182,Storks,99,50,57,206,68,0,2024-04-04
183,Cortez,62,62,58,182,60,0,2024-04-08
184,Cleife,74,51,86,211,70,0,2024-04-04
185,Ivakin,84,86,73,243,81,0,2024-04-07
186,Slowgrove,98,89,96,283,94,0,2024-04-05
187,Mazzia,73,51,59,183,61,0,2024-04-08
188,Izat,61,86,82,229,76,0,2024-04-05
189,Minchin,94,57,66,217,72,0,2024-04-03
190,Costa,68,71,57,196,65,0,2024-04-08
191,Victor,87,83,89,259,86,0,2024-04-06
192,Walsh,52,80,93,225,75,0,2024-04-01
193,Newey,94,52,64,210,70,0,2024-04-08
194,Tewkesberry,56,61,53,170,56,0,2024-04-07
195,Messam,66,71,55,192,64,0,2024-04-02
196,Bettleson,89,85,97,271,90,0,2024-04-04
197,Lowdiane,96,96,74,266,88,0,2024-04-03
198,Daens,50,94,99,243,81,0,2024-04-08
199,MacGorley,80,90,60,230,76,0,2024-04-04
200,O'Dreain,55,62,85,202,67,0,2024-04-02
201,Haydock,65,85,83,233,77,0,2024-04-03
202,Yanin,93,66,53,212,70,0,2024-04-06
203,Meekins,57,67,89,213,71,0,2024-04-07
204,Morriarty,66,81,86,233,77,0,2024-04-09
205,Gotthard,72,71,95,238,79,0,2024-04-07
206,Thowless,63,56,50,169,56,0,2024-04-05
207,Stook,64,61,88,213,71,0,2024-04-08
208,Beardsdale,51,97,99,247,82,0,2024-04-07
209,Rubenfeld,92,70,74,236,78,0,2024-04-07
210,Abthorpe,82,60,85,227,75,0,2024-04-08
211,Lillyman,81,88,73,242,80,0,2024-04-07
212,Emnoney,64,91,73,228,76,0,2024-04-07
213,Otteridge,83,72,91,246,82,0,2024-04-03
214,Dunk,54,79,76,209,69,0,2024-04-02
215,Risbrough,59,54,55,168,56,0,2024-04-05
216,Korbmaker,52,65,83,200,66,0,2024-04-09
217,Bruggeman,64,63,86,213,71,0,2024-04-05
218,Carne,99,61,75,235,78,0,2024-04-02
219,Tamlett,81,52,67,200,66,0,2024-04-02
220,Szimon,53,62,77,192,64,0,2024-04-07
221,Scohier,73,57,57,187,62,0,2024-04-05
222,Benns,94,98,64,256,85,0,2024-04-08
223,McGlew,81,55,76,212,70,0,2024-04-09
224,Brazenor,71,97,70,238,79,0,2024-04-06
225,Buterton,56,83,82,221,73,0,2024-04-02
226,Fysh,77,93,63,233,77,0,2024-04-07
227,Dampney,96,59,95,250,83,0,2024-04-05
228,Dombrell,69,80,61,210,70,0,2024-04-07
229,Todaro,79,78,91,248,82,0,2024-04-01
230,McIlwrick,65,71,87,223,74,0,2024-04-06
231,Weatherhogg,87,58,74,219,73,0,2024-04-08
232,Radbone,65,58,71,194,64,0,2024-04-02
233,Copnall,50,93,75,218,72,0,2024-04-01
234,Sandyford,76,64,94,234,78,0,2024-04-09
235,Pond-Jones,98,70,78,246,82,0,2024-04-08
236,Kabisch,62,58,56,176,58,0,2024-04-02
237,Ackwood,93,68,96,257,85,0,2024-04-01
238,Breitler,69,99,93,261,87,0,2024-04-06
239,Goundry,90,83,94,267,89,0,2024-04-09
240,Amott,57,50,96,203,67,0,2024-04-05
241,Turone,78,56,55,189,63,0,2024-04-05
242,Shane,89,90,84,263,87,0,2024-04-05
243,Brookes,74,59,76,209,69,0,2024-04-02
244,Reck,59,60,88,207,69,0,2024-04-05
245,Menlove,77,68,95,240,80,0,2024-04-03
246,Shirlaw,76,67,62,205,68,0,2024-04-02
247,Hinken,99,86,65,250,83,0,2024-04-05
248,Grioli,85,55,78,218,72,0,2024-04-08
249,Yglesia,86,65,74,225,75,0,2024-04-06
250,Sandhill,54,54,93,201,67,0,2024-04-01
251,Surmeyers,99,99,95,293,97,0,2024-04-08
252,Buckthorpe,73,68,88,229,76,0,2024-04-04
253,Alcide,91,88,64,243,81,0,2024-04-06
254,Alabaster,82,93,60,235,78,0,2024-04-02
255,Flaherty,74,53,96,223,74,0,2024-04-08
256,Jedrzejewicz,65,64,82,211,70,0,2024-04-09
257,Igglesden,78,71,88,237,79,0,2024-04-04
258,Duchant,84,69,89,242,80,0,2024-04-06
259,Back,70,91,78,239,79,0,2024-04-09
260,Treamayne,90,60,84,234,78,0,2024-04-08
261,Poundsford,61,55,69,185,61,0,2024-04-08
262,Kimbell,54,94,87,235,78,0,2024-04-03
263,Yankishin,73,100,74,247,82,0,2024-04-07
264,Basnett,82,91,61,234,78,0,2024-04-03
265,Meeking,86,94,56,236,78,0,2024-04-02
266,Klaussen,66,57,78,201,67,0,2024-04-01
267,Scriver,89,81,68,238,79,0,2024-04-04
268,McCall,75,72,68,215,71,0,2024-04-01
269,Greenroad,75,99,88,262,87,0,2024-04-09
270,Moens,96,78,62,236,78,0,2024-04-04
271,Palphramand,97,51,80,228,76,0,2024-04-09
272,Zarfai,100,58,90,248,82,0,2024-04-05
273,Scutchings,87,98,50,235,78,0,2024-04-05
274,Sand,52,86,87,225,75,0,2024-04-09
275,Sherwin,86,58,69,213,71,0,2024-04-08
276,Grannell,87,71,68,226,75,0,2024-04-09
277,Crosswaite,69,83,82,234,78,0,2024-04-05
278,Elegood,60,69,62,191,63,0,2024-04-01
279,Booley,81,82,76,239,79,0,2024-04-09
280,Dameisele,99,90,88,277,92,0,2024-04-02
281,Spiby,77,71,85,233,77,0,2024-04-03
282,Bridges,50,79,84,213,71,0,2024-04-02
283,Heningam,61,57,79,197,65,0,2024-04-06
284,Kief,57,100,97,254,84,0,2024-04-04
285,Itzkovich,62,64,84,210,70,0,2024-04-05
286,Frigout,57,89,50,196,65,0,2024-04-07
287,Fawdry,70,91,51,212,70,0,2024-04-04
288,Stickells,90,64,51,205,68,0,2024-04-07
289,Farthing,58,58,64,180,60,0,2024-04-02
290,Dakin,84,75,92,251,83,0,2024-04-06
291,Cripwell,61,99,73,233,77,0,2024-04-04
292,Marthen,71,50,77,198,66,0,2024-04-07
293,Rymmer,61,83,60,204,68,0,2024-04-05
294,Fleg,81,81,77,239,79,0,2024-04-01
295,Dwelley,78,62,97,237,79,0,2024-04-03
296,Margaret,95,89,97,281,93,0,2024-04-01
297,Maddock,93,79,64,236,78,0,2024-04-06
298,Rogers,98,89,98,285,95,0,2024-04-07
299,Fright,95,79,54,228,76,0,2024-04-09
300,McKeighen,89,61,80,230,76,0,2024-04-06
301,Calles,85,86,81,252,84,0,2024-04-09
302,Valentim,75,67,50,192,64,0,2024-04-08
303,Kilmaster,86,61,60,207,69,0,2024-04-02
304,Le Port,76,61,51,188,62,0,2024-04-08
305,Louca,76,73,90,239,79,0,2024-04-02
306,Devanney,88,84,79,251,83,0,2024-04-09
307,Meier,61,69,72,202,67,0,2024-04-04
308,Middler,79,80,60,219,73,0,2024-04-03
309,Neild,89,91,72,252,84,0,2024-04-06
310,Sheward,96,66,63,225,75,0,2024-04-07
311,Ealles,66,89,58,213,71,0,2024-04-05
312,Oldfield,70,65,75,210,70,0,2024-04-07
313,Shee,78,86,86,250,83,0,2024-04-07
314,Bugg,55,89,99,243,81,0,2024-04-06
315,Eschalette,57,51,98,206,68,0,2024-04-06
316,Cloutt,96,71,82,249,83,0,2024-04-06
317,Forri,66,67,66,199,66,0,2024-04-03
318,Rockhall,73,81,100,254,84,0,2024-04-09
319,Murton,53,80,61,194,64,0,2024-04-09
320,Maker,93,71,81,245,81,0,2024-04-04
321,Cree,78,59,91,228,76,0,2024-04-03
322,Vickarman,92,50,98,240,80,0,2024-04-04
323,Silber,57,83,71,211,70,0,2024-04-09
324,Dumphry,60,78,55,193,64,0,2024-04-09
325,Astman,79,60,87,226,75,0,2024-04-06
326,Blackly,100,64,80,244,81,0,2024-04-06
327,Messer,77,86,53,216,72,0,2024-04-04
328,Roofe,70,73,99,242,80,0,2024-04-07
329,Puleston,63,64,61,188,62,0,2024-04-01
330,Hincks,93,61,53,207,69,0,2024-04-09
331,Houtby,83,78,78,239,79,0,2024-04-03
332,Haglington,72,85,89,246,82,0,2024-04-07
333,Picheford,59,80,89,228,76,0,2024-04-07
334,Falco,100,52,52,204,68,0,2024-04-07
335,Chart,61,69,83,213,71,0,2024-04-08
336,Bollands,60,92,52,204,68,0,2024-04-06
337,Bussen,78,60,58,196,65,0,2024-04-03
338,Fassman,56,100,65,221,73,0,2024-04-07
339,Mochar,88,85,71,244,81,0,2024-04-04
340,Zoane,84,86,51,221,73,0,2024-04-02
341,Grog,82,75,67,224,74,0,2024-04-09
342,Twine,85,84,76,245,81,0,2024-04-02
343,O'Carroll,72,74,67,213,71,0,2024-04-05
344,Conduit,91,77,60,228,76,0,2024-04-02
345,Dekeyser,91,90,55,236,78,0,2024-04-04
346,Duffell,75,78,93,246,82,0,2024-04-02
347,Lannin,82,95,61,238,79,0,2024-04-09
348,Matuszynski,83,56,85,224,74,0,2024-04-06
349,Ubsdale,55,83,62,200,66,0,2024-04-03
350,McQuaid,75,75,73,223,74,0,2024-04-01
351,Houlahan,50,86,96,232,77,0,2024-04-02
352,MacCrossan,58,60,52,170,56,0,2024-04-07
353,Bartels-Ellis,52,95,51,198,66,0,2024-04-02
354,Allerton,88,93,80,261,87,0,2024-04-02
355,Denziloe,51,94,98,243,81,0,2024-04-09
356,Fogg,81,65,59,205,68,0,2024-04-08
357,Nortunen,61,58,86,205,68,0,2024-04-04
358,Yansons,91,87,64,242,80,0,2024-04-01
359,Sevier,53,53,70,176,58,0,2024-04-05
360,Greasty,100,91,74,265,88,0,2024-04-01
361,Ouldcott,51,95,50,196,65,0,2024-04-02
362,Toffler,93,83,90,266,88,0,2024-04-06
363,Fulstow,66,81,92,239,79,0,2024-04-01
364,Rosebotham,61,81,52,194,64,0,2024-04-07
365,Trayte,74,70,75,219,73,0,2024-04-07
366,Belsey,78,73,59,210,70,0,2024-04-09
367,Gallegos,64,66,71,201,67,0,2024-04-01
368,Coggles,82,74,88,244,81,0,2024-04-05
369,McKinney,68,81,91,240,80,0,2024-04-02
370,Hartzog,69,57,62,188,62,0,2024-04-05
371,Heeran,95,92,94,281,93,0,2024-04-06
372,Shadfourth,87,61,51,199,66,0,2024-04-05
373,Bradock,62,55,82,199,66,0,2024-04-04
374,Orsi,72,80,97,249,83,0,2024-04-08
375,Garnsey,74,93,54,221,73,0,2024-04-07
376,Merrigans,62,51,79,192,64,0,2024-04-02
377,Kearney,88,84,72,244,81,0,2024-04-06
378,Tompion,55,87,80,222,74,0,2024-04-05
379,Trencher,56,94,60,210,70,0,2024-04-09
380,Goghin,78,84,53,215,71,0,2024-04-01
381,Lenglet,70,93,63,226,75,0,2024-04-01
382,Harmour,66,96,67,229,76,0,2024-04-05
383,Rackham,90,72,95,257,85,0,2024-04-07
384,Sirett,71,57,71,199,66,0,2024-04-01
385,Stockwell,73,81,96,250,83,0,2024-04-03
386,Bareford,88,64,97,249,83,0,2024-04-08
387,Welberry,68,83,57,208,69,0,2024-04-01
388,Izen,92,93,55,240,80,0,2024-04-01
389,Kleinhaus,100,95,95,290,96,0,2024-04-02
390,Wallen,93,60,64,217,72,0,2024-04-07
391,Bain,67,52,70,189,63,0,2024-04-07
392,Chilvers,83,94,69,246,82,0,2024-04-05
393,Zmitrichenko,53,63,61,177,59,0,2024-04-07
394,Behnke,97,97,59,253,84,0,2024-04-06
395,Wherrett,93,93,71,257,85,0,2024-04-01
396,St Pierre,69,82,84,235,78,0,2024-04-08
397,Kettell,65,99,91,255,85,0,2024-04-08
398,Nijs,87,72,81,240,80,0,2024-04-09
399,Sheilds,88,95,87,270,90,0,2024-04-04
400,Orehead,84,88,52,224,74,0,2024-04-09
401,Loynes,81,65,92,238,79,0,2024-04-01
402,Lerigo,80,80,90,250,83,0,2024-04-08
403,Smeal,94,71,94,259,86,0,2024-04-03
404,Ricioppo,52,91,76,219,73,0,2024-04-09
405,Hassard,80,78,77,235,78,0,2024-04-05
406,McClory,83,74,52,209,69,0,2024-04-04
407,Palke,98,50,66,214,71,0,2024-04-04
408,Ladbrook,58,100,50,208,69,0,2024-04-05
409,Gammie,96,71,52,219,73,0,2024-04-08
410,McKendry,54,52,56,162,54,0,2024-04-04
411,Pettingall,64,94,58,216,72,0,2024-04-06
412,Fooks,57,51,62,170,56,0,2024-04-09
413,Melsom,80,52,51,183,61,0,2024-04-04
414,Thurber,53,89,69,211,70,0,2024-04-05
415,Manners,93,53,52,198,66,0,2024-04-02
416,Piscot,50,77,58,185,61,0,2024-04-02
417,Paragreen,91,100,86,277,92,0,2024-04-08
418,Schollar,99,55,90,244,81,0,2024-04-08
419,Leve,77,90,93,260,86,0,2024-04-03
420,Brummell,53,98,95,246,82,0,2024-04-05
421,Andrusyak,53,67,98,218,72,0,2024-04-08
422,Quest,78,76,69,223,74,0,2024-04-01
423,Gillis,90,85,92,267,89,0,2024-04-04
424,Jelk,63,80,67,210,70,0,2024-04-01
425,Chevers,82,86,99,267,89,0,2024-04-01
426,Foxhall,85,59,77,221,73,0,2024-04-05
427,Hum,74,71,73,218,72,0,2024-04-03
428,Overill,59,100,62,221,73,0,2024-04-09
429,Kohter,98,87,68,253,84,0,2024-04-05
430,Bourthouloume,90,94,93,277,92,0,2024-04-05
431,Duligal,73,66,62,201,67,0,2024-04-04
432,Feechan,53,79,51,183,61,0,2024-04-05
433,Gartenfeld,59,65,67,191,63,0,2024-04-03
434,Willson,98,67,90,255,85,0,2024-04-04
435,Brunsdon,96,97,80,273,91,0,2024-04-04
436,Gooke,96,52,77,225,75,0,2024-04-07
437,Hariot,53,75,64,192,64,0,2024-04-04
438,Stokes,89,57,62,208,69,0,2024-04-04
439,Brambley,94,62,76,232,77,0,2024-04-03
440,Ensor,76,51,52,179,59,0,2024-04-03
441,Treweek,94,59,96,249,83,0,2024-04-09
442,Decaze,55,79,56,190,63,0,2024-04-05
443,Bezants,97,54,50,201,67,0,2024-04-02
444,Ivatts,64,84,74,222,74,0,2024-04-06
445,Mishaw,53,52,90,195,65,0,2024-04-07
446,Carslake,95,59,64,218,72,0,2024-04-09
447,Pritchard,82,97,90,269,89,0,2024-04-09
448,Pietzker,74,52,83,209,69,0,2024-04-09
449,Lodeke,92,68,57,217,72,0,2024-04-05
450,Robbe,95,93,66,254,84,0,2024-04-01
451,Prazor,92,51,87,230,76,0,2024-04-04
452,Abbes,63,62,66,191,63,0,2024-04-09
453,McMaster,64,77,60,201,67,0,2024-04-08
454,Burthom,63,73,50,186,62,0,2024-04-04
455,Pratty,64,79,56,199,66,0,2024-04-07
456,Cuerdale,56,75,77,208,69,0,2024-04-03
457,Collum,95,80,99,274,91,0,2024-04-05
458,Blindmann,84,91,56,231,77,0,2024-04-03
459,Halward,97,85,80,262,87,0,2024-04-07
460,Dollar,69,82,85,236,78,0,2024-04-06
461,Jeffs,74,52,91,217,72,0,2024-04-08
462,Danks,73,78,77,228,76,0,2024-04-07
463,Haton,50,98,100,248,82,0,2024-04-05
464,Roderick,58,67,65,190,63,0,2024-04-03
465,McAughtrie,61,92,94,247,82,0,2024-04-02
466,Skudder,79,80,52,211,70,0,2024-04-04
467,Nehlsen,85,98,81,264,88,0,2024-04-05
468,Eastes,55,93,87,235,78,0,2024-04-03
469,Broggio,67,97,82,246,82,0,2024-04-02
470,McCreery,96,80,68,244,81,0,2024-04-06
471,Neumann,59,86,68,213,71,0,2024-04-09
472,Romanini,86,52,88,226,75,0,2024-04-05
473,Cunniff,94,77,94,265,88,0,2024-04-09
474,Cicchetto,75,56,54,185,61,0,2024-04-02
475,Wright,64,60,94,218,72,0,2024-04-07
476,Parkman,72,73,67,212,70,0,2024-04-04
477,Cholerton,97,83,53,233,77,0,2024-04-01
478,Figge,89,75,91,255,85,0,2024-04-01
479,Pergens,70,66,87,223,74,0,2024-04-01
480,Rolfo,79,74,51,204,68,0,2024-04-07
481,Allender,52,73,74,199,66,0,2024-04-03
482,Kelcey,87,66,75,228,76,0,2024-04-06
483,Middlewick,50,66,84,200,66,0,2024-04-08
484,Benzies,51,50,93,194,64,0,2024-04-05
485,Getty,63,92,56,211,70,0,2024-04-09
486,Kunze,100,96,86,282,94,0,2024-04-03
487,Cluney,53,50,82,185,61,0,2024-04-02
488,Scawen,85,57,63,205,68,0,2024-04-05
489,Keddie,70,68,83,221,73,0,2024-04-02
490,Purcell,52,69,51,172,57,0,2024-04-02
491,MacCartan,74,73,73,220,73,0,2024-04-07
492,Lemme,69,70,79,218,72,0,2024-04-03
493,Gullam,51,51,62,164,54,0,2024-04-04
494,Jeppensen,91,77,72,240,80,0,2024-04-04
495,Ovington,79,59,85,223,74,0,2024-04-09
496,Di Franceshci,52,82,92,226,75,0,2024-04-08
497,Loughran,66,96,83,245,81,0,2024-04-02
498,Ewols,95,74,89,258,86,0,2024-04-07
499,Mostyn,60,83,67,210,70,0,2024-04-06
500,Eneas,73,61,85,219,73,0,2024-04-05
501,Roubeix,60,72,61,193,64,0,2024-04-06
502,Pascoe,59,78,94,231,77,0,2024-04-09
503,Stowell,95,78,94,267,89,0,2024-04-08
504,Salvatore,82,58,74,214,71,0,2024-04-08
505,Fones,64,69,58,191,63,0,2024-04-05
506,Deverale,68,96,84,248,82,0,2024-04-01
507,Sothern,57,93,57,207,69,0,2024-04-07
508,Brice,98,87,84,269,89,0,2024-04-07
509,Crackel,52,95,56,203,67,0,2024-04-04
510,Jedrachowicz,77,90,99,266,88,0,2024-04-08
511,Denson,80,82,90,252,84,0,2024-04-04
512,Pinckney,63,97,67,227,75,0,2024-04-06
513,Turbitt,76,78,82,236,78,0,2024-04-05
514,Andersch,98,77,53,228,76,0,2024-04-01
515,Pentelow,90,60,90,240,80,0,2024-04-04
516,Wetherhead,75,79,76,230,76,0,2024-04-02
517,Wincott,88,74,75,237,79,0,2024-04-03
518,Cockill,51,81,61,193,64,0,2024-04-04
519,Pretsel,67,89,56,212,70,0,2024-04-04
520,Tineman,55,83,57,195,65,0,2024-04-09
521,Duester,85,70,89,244,81,0,2024-04-05
522,Lead,86,88,69,243,81,0,2024-04-06
523,Stratiff,73,85,93,251,83,0,2024-04-07
524,Dorning,70,85,56,211,70,0,2024-04-04
525,Huntar,57,99,59,215,71,0,2024-04-05
526,McKeurtan,78,94,95,267,89,0,2024-04-08
527,Pirrie,100,52,64,216,72,0,2024-04-02
528,Wippermann,65,98,76,239,79,0,2024-04-04
529,Middas,69,51,70,190,63,0,2024-04-06
530,Gouldie,72,67,63,202,67,0,2024-04-09
531,McLanaghan,94,61,73,228,76,0,2024-04-05
532,Dicte,57,81,64,202,67,0,2024-04-04
533,Plak,80,84,78,242,80,0,2024-04-02
534,Behnen,98,96,91,285,95,0,2024-04-01
535,Yeldon,87,73,91,251,83,0,2024-04-03
536,Salliere,88,50,75,213,71,0,2024-04-01
537,Gobel,100,75,78,253,84,0,2024-04-04
538,Wickins,71,62,61,194,64,0,2024-04-01
539,Dureden,94,66,91,251,83,0,2024-04-04
540,Donett,78,78,50,206,68,0,2024-04-07
541,Cuesta,72,59,54,185,61,0,2024-04-03
542,Ghidetti,63,86,82,231,77,0,2024-04-03
543,Sabates,81,79,90,250,83,0,2024-04-07
544,Allnatt,74,100,77,251,83,0,2024-04-03
545,Cicchillo,89,52,63,204,68,0,2024-04-06
546,O' Gara,68,82,68,218,72,0,2024-04-08
547,Aloigi,93,86,96,275,91,0,2024-04-04
548,Haysey,87,87,80,254,84,0,2024-04-09
549,Cheeke,63,63,86,212,70,0,2024-04-01
550,Radage,87,57,71,215,71,0,2024-04-02
551,Bosquet,57,75,90,222,74,0,2024-04-04
552,Kulver,52,90,59,201,67,0,2024-04-07
553,Knevit,60,61,71,192,64,0,2024-04-06
554,Staynes,65,80,52,197,65,0,2024-04-04
555,McGraith,67,100,94,261,87,0,2024-04-07
556,Rowbotham,83,64,52,199,66,0,2024-04-07
557,Laidlaw,74,92,92,258,86,0,2024-04-04
558,Bartalini,54,68,80,202,67,0,2024-04-04
559,Keefe,91,69,62,222,74,0,2024-04-05
560,Tann,64,70,90,224,74,0,2024-04-03
561,Vibert,98,66,74,238,79,0,2024-04-03
562,Linskill,86,89,82,257,85,0,2024-04-09
563,Villar,54,60,90,204,68,0,2024-04-03
564,O'Deegan,52,60,85,197,65,0,2024-04-03
565,Tombling,85,88,81,254,84,0,2024-04-05
566,Bang,67,98,79,244,81,0,2024-04-09
567,Timmis,59,97,77,233,77,0,2024-04-02
568,Alekhov,69,62,74,205,68,0,2024-04-09
569,Pirolini,50,60,70,180,60,0,2024-04-07
570,Lipgens,88,93,94,275,91,0,2024-04-06
571,A'field,56,83,50,189,63,0,2024-04-03
572,Hegley,90,59,55,204,68,0,2024-04-03
573,Doblin,87,70,72,229,76,0,2024-04-08
574,Cahan,99,82,61,242,80,0,2024-04-05
575,Tathacott,88,66,72,226,75,0,2024-04-01
576,Leebeter,70,69,64,203,67,0,2024-04-09
577,Hammett,72,97,63,232,77,0,2024-04-06
578,Ahlf,50,88,79,217,72,0,2024-04-08
579,Kettles,52,68,74,194,64,0,2024-04-01
580,Roffey,73,52,75,200,66,0,2024-04-04
581,Sagg,67,69,81,217,72,0,2024-04-05
582,Jones,94,66,100,260,86,0,2024-04-07
583,Corsan,85,60,84,229,76,0,2024-04-01
584,Hamblington,62,77,89,228,76,0,2024-04-08
585,Swaden,100,70,79,249,83,0,2024-04-08
586,Myrkus,94,76,56,226,75,0,2024-04-05
587,Sergean,67,91,73,231,77,0,2024-04-02
588,Tewkesbury.,82,68,86,236,78,0,2024-04-07
589,Fenby,51,61,55,167,55,0,2024-04-04
590,Watchorn,56,95,75,226,75,0,2024-04-08
591,Shadfourth,83,98,59,240,80,0,2024-04-06
592,Scruby,84,68,79,231,77,0,2024-04-07
593,McGrudder,95,69,67,231,77,0,2024-04-01
594,Westmoreland,54,53,62,169,56,0,2024-04-06
595,Aldhous,86,89,71,246,82,0,2024-04-05
596,Mac Giany,100,93,100,293,97,0,2024-04-03
597,Mighele,67,72,89,228,76,0,2024-04-05
598,Asmus,57,66,57,180,60,0,2024-04-03
599,McCord,57,58,87,202,67,0,2024-04-04
600,Crafter,66,53,70,189,63,0,2024-04-05
601,Starling,51,50,71,172,57,0,2024-04-03
602,Rattray,83,97,96,276,92,0,2024-04-02
603,Deluze,87,76,91,254,84,0,2024-04-06
604,Tripony,57,58,62,177,59,0,2024-04-05
605,Isakovitch,56,69,51,176,58,0,2024-04-05
606,Kittle,97,57,67,221,73,0,2024-04-03
607,Palser,99,58,76,233,77,0,2024-04-03
608,Cody,82,71,72,225,75,0,2024-04-01
609,Smiths,75,92,86,253,84,0,2024-04-02
610,Casetta,50,92,77,219,73,0,2024-04-09
611,Klagges,83,71,90,244,81,0,2024-04-03
612,Clulee,82,77,67,226,75,0,2024-04-04
613,Heinsius,66,76,50,192,64,0,2024-04-08
614,Martynov,53,73,96,222,74,0,2024-04-03
615,Janman,76,71,53,200,66,0,2024-04-07
616,Cullen,95,99,80,274,91,0,2024-04-04
617,MacAlester,57,88,60,205,68,0,2024-04-05
618,Edrich,64,97,97,258,86,0,2024-04-08
619,Lovstrom,88,88,89,265,88,0,2024-04-06
620,Bartrum,84,60,83,227,75,0,2024-04-03
621,Pautard,98,77,55,230,76,0,2024-04-07
622,Brettell,75,63,94,232,77,0,2024-04-05
623,Streeter,56,86,63,205,68,0,2024-04-03
624,Oldam,57,95,96,248,82,0,2024-04-07
625,Londesborough,67,69,82,218,72,0,2024-04-04
626,Raoux,74,52,98,224,74,0,2024-04-02
627,MacCombe,74,91,74,239,79,0,2024-04-02
628,Rowth,59,76,87,222,74,0,2024-04-04
629,Kovalski,89,68,86,243,81,0,2024-04-09
630,Soigoux,57,96,54,207,69,0,2024-04-08
631,Slowgrave,63,84,97,244,81,0,2024-04-02
632,Dunklee,50,96,74,220,73,0,2024-04-03
633,Vobes,54,94,61,209,69,0,2024-04-06
634,Cahalan,64,94,55,213,71,0,2024-04-09
635,Smee,86,77,66,229,76,0,2024-04-02
636,McGillacoell,96,97,82,275,91,0,2024-04-03
637,Beat,64,78,61,203,67,0,2024-04-07
638,Wimbush,97,60,56,213,71,0,2024-04-03
639,Jarley,94,61,78,233,77,0,2024-04-01
640,Kemitt,95,83,60,238,79,0,2024-04-04
641,Reddlesden,75,79,74,228,76,0,2024-04-06
642,Garlant,83,61,78,222,74,0,2024-04-01
643,Merriday,67,50,73,190,63,0,2024-04-04
644,Burril,88,98,74,260,86,0,2024-04-08
645,Wettern,65,59,63,187,62,0,2024-04-03
646,Chataignier,67,71,90,228,76,0,2024-04-01
647,Demeza,64,62,100,226,75,0,2024-04-08
648,Rennocks,72,72,87,231,77,0,2024-04-06
649,Crosseland,56,63,56,175,58,0,2024-04-01
650,Eakeley,51,83,79,213,71,0,2024-04-07
651,Althorp,67,73,90,230,76,0,2024-04-06
652,Algar,91,67,99,257,85,0,2024-04-04
653,Gabitis,69,83,64,216,72,0,2024-04-01
654,Firle,65,80,98,243,81,0,2024-04-03
655,Hessenthaler,50,66,60,176,58,0,2024-04-07
656,Kleinerman,82,92,74,248,82,0,2024-04-07
657,Van der Kruys,52,60,80,192,64,0,2024-04-01
658,Ivashkin,58,76,85,219,73,0,2024-04-08
659,Ferris,93,84,57,234,78,0,2024-04-06
660,McGaugey,60,53,73,186,62,0,2024-04-04
661,Stanesby,83,80,60,223,74,0,2024-04-09
662,Benoix,79,51,63,193,64,0,2024-04-07
663,Tanswill,77,66,99,242,80,0,2024-04-05
664,Bukowski,96,53,64,213,71,0,2024-04-06
665,Brignell,75,51,74,200,66,0,2024-04-01
666,Stredder,80,96,66,242,80,0,2024-04-06
667,Aleksandrov,82,96,72,250,83,0,2024-04-07
668,Beckett,51,51,52,154,51,0,2024-04-07
669,Julyan,93,54,78,225,75,0,2024-04-05
670,MacKinnon,66,57,60,183,61,0,2024-04-09
671,Ledeker,58,82,63,203,67,0,2024-04-03
672,Sherel,72,60,71,203,67,0,2024-04-07
673,Crenage,85,65,92,242,80,0,2024-04-04
674,Quilligan,78,66,89,233,77,0,2024-04-07
675,Burless,57,55,60,172,57,0,2024-04-06
676,Renahan,79,98,72,249,83,0,2024-04-05
677,Lewendon,97,74,82,253,84,0,2024-04-04
678,Aitken,70,65,74,209,69,0,2024-04-07
679,Eadie,88,83,88,259,86,0,2024-04-04
680,Folomkin,62,58,62,182,60,0,2024-04-04
681,Serjeant,90,87,71,248,82,0,2024-04-09
682,Durn,93,93,56,242,80,0,2024-04-03
683,Rabl,89,74,56,219,73,0,2024-04-05
684,Rawls,51,62,78,191,63,0,2024-04-08
685,Feeny,63,83,96,242,80,0,2024-04-08
686,Malecky,71,86,50,207,69,0,2024-04-01
687,Glass,64,96,85,245,81,0,2024-04-05
688,Scanes,50,79,62,191,63,0,2024-04-03
689,Thripp,80,85,100,265,88,0,2024-04-02
690,Gammack,69,85,89,243,81,0,2024-04-09
691,Cahillane,74,61,98,233,77,0,2024-04-02
692,Wilby,70,73,91,234,78,0,2024-04-01
693,Timmins,63,64,71,198,66,0,2024-04-04
694,Al Hirsi,93,94,92,279,93,0,2024-04-07
695,Scutter,91,90,68,249,83,0,2024-04-04
696,Muskett,54,74,71,199,66,0,2024-04-07
697,Wilmut,76,93,69,238,79,0,2024-04-03
698,Clackers,63,81,72,216,72,0,2024-04-09
699,Bisacre,91,70,62,223,74,0,2024-04-04
700,Entres,71,95,65,231,77,0,2024-04-03
701,Vasyaev,76,72,99,247,82,0,2024-04-09
702,Marion,59,50,51,160,53,0,2024-04-09
703,Extill,60,74,58,192,64,0,2024-04-06
704,Bridden,65,82,66,213,71,0,2024-04-05
705,Cabrer,82,67,83,232,77,0,2024-04-06
706,De Witt,51,92,93,236,78,0,2024-04-06
707,Geffe,51,73,66,190,63,0,2024-04-05
708,Dy,60,70,73,203,67,0,2024-04-09
709,Fenning,57,74,64,195,65,0,2024-04-01
710,Loverock,98,71,76,245,81,0,2024-04-04
711,Winterflood,79,80,61,220,73,0,2024-04-06
712,Baltzar,50,77,67,194,64,0,2024-04-07
713,Eefting,73,55,77,205,68,0,2024-04-03
714,Devigne,98,64,80,242,80,0,2024-04-07
715,Phibb,82,88,74,244,81,0,2024-04-08
716,Parnell,50,71,84,205,68,0,2024-04-05
717,Vedyashkin,98,89,61,248,82,0,2024-04-04
718,Jope,94,56,60,210,70,0,2024-04-09
719,Bruster,70,85,80,235,78,0,2024-04-07
720,Tuckwood,92,52,91,235,78,0,2024-04-03
721,Handasyde,60,76,61,197,65,0,2024-04-04
722,Spark,53,80,95,228,76,0,2024-04-01
723,Bargery,94,77,84,255,85,0,2024-04-08
724,Courtney,74,98,78,250,83,0,2024-04-07
725,Shalcras,82,93,90,265,88,0,2024-04-05
726,Dofty,72,70,95,237,79,0,2024-04-08
727,Beynke,67,52,82,201,67,0,2024-04-07
728,Challens,86,88,78,252,84,0,2024-04-09
729,Witt,50,82,77,209,69,0,2024-04-04
730,Lesley,74,70,61,205,68,0,2024-04-06
731,Billingsly,94,70,78,242,80,0,2024-04-05
732,Gelardi,61,68,51,180,60,0,2024-04-06
733,Fuge,70,60,52,182,60,0,2024-04-02
734,Broomfield,76,60,83,219,73,0,2024-04-06
735,Waddam,100,82,55,237,79,0,2024-04-02
736,Papaminas,91,51,95,237,79,0,2024-04-05
737,Karolowski,51,71,80,202,67,0,2024-04-09
738,Guihen,88,84,95,267,89,0,2024-04-08
739,Irlam,90,90,59,239,79,0,2024-04-03
740,Sandercock,61,96,75,232,77,0,2024-04-05
741,Trenholm,64,87,75,226,75,0,2024-04-01
742,Ghiraldi,68,90,82,240,80,0,2024-04-03
743,Clayson,73,57,59,189,63,0,2024-04-01
744,Sapsford,85,70,85,240,80,0,2024-04-03
745,Peres,86,57,58,201,67,0,2024-04-05
746,Eglise,97,98,91,286,95,0,2024-04-06
747,Farfull,55,94,91,240,80,0,2024-04-04
748,Lucian,78,76,75,229,76,0,2024-04-01
749,Hosburn,97,96,74,267,89,0,2024-04-02
750,Teliga,65,65,100,230,76,0,2024-04-09
751,Englishby,80,99,60,239,79,0,2024-04-08
752,Lanning,64,100,73,237,79,0,2024-04-01
753,Hendriksen,66,82,100,248,82,0,2024-04-06
754,Tapper,86,77,58,221,73,0,2024-04-08
755,Askaw,70,65,76,211,70,0,2024-04-06
756,Gingold,75,99,67,241,80,0,2024-04-08
757,Prickett,81,97,91,269,89,0,2024-04-01
758,Isack,51,69,83,203,67,0,2024-04-09
759,Cornu,60,76,79,215,71,0,2024-04-07
760,Belsham,79,95,53,227,75,0,2024-04-01
761,Reavey,71,76,68,215,71,0,2024-04-06
762,Klimontovich,96,51,91,238,79,0,2024-04-01
763,McLean,86,98,66,250,83,0,2024-04-07
764,Hegarty,77,91,75,243,81,0,2024-04-05
765,Darlasson,60,64,65,189,63,0,2024-04-04
766,Deveril,62,79,73,214,71,0,2024-04-05
767,Gurton,100,62,90,252,84,0,2024-04-06
768,Millom,51,57,64,172,57,0,2024-04-06
769,Reina,71,74,77,222,74,0,2024-04-08
770,Shewry,65,99,56,220,73,0,2024-04-08
771,Yielding,54,75,77,206,68,0,2024-04-04
772,Spriggs,58,58,57,173,57,0,2024-04-08
773,Yanov,60,66,73,199,66,0,2024-04-01
774,Wann,65,97,83,245,81,0,2024-04-04
775,Lorentz,64,93,95,252,84,0,2024-04-05
776,Sonley,73,93,66,232,77,0,2024-04-07
777,Fontenot,74,62,69,205,68,0,2024-04-07
778,Morigan,92,63,94,249,83,0,2024-04-04
779,Hanning,77,72,64,213,71,0,2024-04-05
780,Christoffels,53,73,96,222,74,0,2024-04-01
781,Rickaby,80,71,92,243,81,0,2024-04-04
782,Stegell,58,80,72,210,70,0,2024-04-06
783,Stoke,59,66,70,195,65,0,2024-04-02
784,Hamper,83,53,83,219,73,0,2024-04-08
785,Skally,61,96,51,208,69,0,2024-04-06
786,Bockh,50,77,57,184,61,0,2024-04-04
787,Seeney,65,56,89,210,70,0,2024-04-05
788,Tallon,79,92,70,241,80,0,2024-04-01
789,Padillo,53,81,72,206,68,0,2024-04-03
790,Rolling,88,86,62,236,78,0,2024-04-03
791,Wastall,91,80,95,266,88,0,2024-04-08
792,St Ledger,50,76,54,180,60,0,2024-04-08
793,Keady,56,51,83,190,63,0,2024-04-05
794,Yokley,76,64,100,240,80,0,2024-04-01
795,Bleyman,66,90,74,230,76,0,2024-04-03
796,Lockner,57,86,77,220,73,0,2024-04-02
797,Bree,96,75,90,261,87,0,2024-04-05
798,Mohan,61,56,85,202,67,0,2024-04-06
799,Kardos,97,83,66,246,82,0,2024-04-01
800,Hurndall,51,82,93,226,75,0,2024-04-06
801,Asmus,79,57,79,215,71,0,2024-04-06
802,McKinna,98,72,64,234,78,0,2024-04-06
803,Jobern,66,59,97,222,74,0,2024-04-05
804,Primmer,89,51,51,191,63,0,2024-04-08
805,Marland,66,78,83,227,75,0,2024-04-02
806,Mulhall,79,100,61,240,80,0,2024-04-04
807,Vassay,90,99,88,277,92,0,2024-04-06
808,Kinghorne,94,91,92,277,92,0,2024-04-01
809,Leadbeatter,96,73,100,269,89,0,2024-04-06
810,O'Mara,85,51,97,233,77,0,2024-04-06
811,Sturrock,51,57,82,190,63,0,2024-04-04
812,Cammock,87,51,78,216,72,0,2024-04-04
813,Betser,54,73,91,218,72,0,2024-04-09
814,Riddock,68,75,63,206,68,0,2024-04-06
815,Bewfield,75,66,77,218,72,0,2024-04-03
816,Vuitte,58,76,52,186,62,0,2024-04-02
817,Cosgriff,58,66,66,190,63,0,2024-04-01
818,Storks,97,88,72,257,85,0,2024-04-07
819,Gilfether,97,52,87,236,78,0,2024-04-03
820,Chatto,69,92,84,245,81,0,2024-04-06
821,Busk,50,76,74,200,66,0,2024-04-03
822,Venny,64,88,94,246,82,0,2024-04-01
823,Gerrens,81,94,94,269,89,0,2024-04-08
824,Dalwood,69,84,74,227,75,0,2024-04-07
825,Truelock,54,84,56,194,64,0,2024-04-09
826,Navein,100,60,82,242,80,0,2024-04-01
827,Simson,63,76,61,200,66,0,2024-04-08
828,Ranvoise,100,55,59,214,71,0,2024-04-04
829,Lambert-Ciorwyn,89,51,56,196,65,0,2024-04-04
830,Di Angelo,89,98,77,264,88,0,2024-04-06
831,Wayne,66,75,75,216,72,0,2024-04-06
832,Cyphus,73,82,100,255,85,0,2024-04-07
833,Deere,75,54,74,203,67,0,2024-04-09
834,Dunabie,70,91,80,241,80,0,2024-04-03
835,Berkeley,73,78,54,205,68,0,2024-04-07
836,Humfrey,52,98,84,234,78,0,2024-04-02
837,Markson,94,84,79,257,85,0,2024-04-06
838,Egdal,55,63,80,198,66,0,2024-04-03
839,Thunnercliffe,62,96,51,209,69,0,2024-04-03
840,Sinkins,91,88,64,243,81,0,2024-04-01
841,Dulwich,99,87,92,278,92,0,2024-04-09
842,Pouton,85,65,76,226,75,0,2024-04-05
843,Graves,98,57,87,242,80,0,2024-04-02
844,Deinert,70,63,95,228,76,0,2024-04-08
845,Smissen,99,86,73,258,86,0,2024-04-03
846,Iacovino,69,84,97,250,83,0,2024-04-09
847,Cours,90,62,81,233,77,0,2024-04-01
848,Bredbury,66,60,89,215,71,0,2024-04-06
849,Trafford,93,83,64,240,80,0,2024-04-01
850,Bagnall,78,81,97,256,85,0,2024-04-09
851,Cough,73,63,64,200,66,0,2024-04-03
852,Rushsorth,67,77,62,206,68,0,2024-04-03
853,Lum,95,87,69,251,83,0,2024-04-02
854,Kingscote,60,69,61,190,63,0,2024-04-03
855,Sperrett,56,79,83,218,72,0,2024-04-01
856,Romme,100,56,99,255,85,0,2024-04-07
857,Nicholson,69,89,100,258,86,0,2024-04-05
858,Pennells,63,100,97,260,86,0,2024-04-01
859,Tonner,75,71,79,225,75,0,2024-04-02
860,Laidler,70,73,79,222,74,0,2024-04-02
861,Duffyn,96,65,73,234,78,0,2024-04-01
862,Cavaney,76,82,78,236,78,0,2024-04-07
863,Garstan,53,94,59,206,68,0,2024-04-06
864,Litchmore,85,86,91,262,87,0,2024-04-02
865,Beardmore,61,58,55,174,58,0,2024-04-07
866,Byway,55,81,96,232,77,0,2024-04-04
867,Shorey,82,76,72,230,76,0,2024-04-01
868,Janman,91,91,78,260,86,0,2024-04-05
869,Almack,79,73,75,227,75,0,2024-04-07
870,McCaighey,83,50,88,221,73,0,2024-04-01
871,Reschke,78,58,51,187,62,0,2024-04-07
872,Darrach,55,78,71,204,68,0,2024-04-07
873,Hodgin,50,60,88,198,66,0,2024-04-02
874,Christoffe,72,80,91,243,81,0,2024-04-06
875,Reaveley,87,88,76,251,83,0,2024-04-04
876,Livingstone,77,58,83,218,72,0,2024-04-09
877,Swallow,80,81,72,233,77,0,2024-04-08
878,Crucitti,92,57,93,242,80,0,2024-04-05
879,Peter,83,61,94,238,79,0,2024-04-01
880,Russilll,97,89,65,251,83,0,2024-04-02
881,Tapscott,76,53,87,216,72,0,2024-04-09
882,Dunkerk,55,97,95,247,82,0,2024-04-04
883,Troppmann,65,99,69,233,77,0,2024-04-05
884,Barstow,83,90,99,272,90,0,2024-04-03
885,Tanslie,76,67,96,239,79,0,2024-04-03
886,Jina,55,85,54,194,64,0,2024-04-06
887,Curragh,100,71,67,238,79,0,2024-04-06
888,Soldan,50,64,71,185,61,0,2024-04-07
889,Bezant,83,93,90,266,88,0,2024-04-08
890,Struss,100,55,61,216,72,0,2024-04-02
891,Alp,52,87,93,232,77,0,2024-04-06
892,Roscher,62,77,68,207,69,0,2024-04-02
893,Merrett,68,60,63,191,63,0,2024-04-01
894,Horrod,53,50,52,155,51,0,2024-04-09
895,Bugdall,75,89,78,242,80,0,2024-04-05
896,Stowers,99,67,62,228,76,0,2024-04-05
897,Logsdale,54,84,82,220,73,0,2024-04-08
898,Cuppitt,58,56,90,204,68,0,2024-04-05
899,Ringe,55,56,59,170,56,0,2024-04-09
900,Trenholm,74,75,83,232,77,0,2024-04-01
901,Rushford,61,76,73,210,70,0,2024-04-07
902,Dedmam,81,99,100,280,93,0,2024-04-06
903,Flaunier,71,58,90,219,73,0,2024-04-01
904,Lewsam,55,88,51,194,64,0,2024-04-03
905,Maundrell,92,66,60,218,72,0,2024-04-07
906,Braker,65,93,54,212,70,0,2024-04-03
907,Scobbie,83,56,96,235,78,0,2024-04-08
908,Parkyns,100,55,67,222,74,0,2024-04-07
909,Aneley,72,80,78,230,76,0,2024-04-08
910,Danilin,76,72,64,212,70,0,2024-04-05
911,Gristhwaite,71,93,77,241,80,0,2024-04-08
912,Kleeman,69,51,59,179,59,0,2024-04-09
913,Yeomans,93,58,81,232,77,0,2024-04-08
914,Swindles,87,72,64,223,74,0,2024-04-09
915,Harnwell,67,94,75,236,78,0,2024-04-02
916,Gerok,52,54,80,186,62,0,2024-04-07
917,Roskrug,82,80,53,215,71,0,2024-04-05
918,Tenant,100,84,57,241,80,0,2024-04-09
919,Swiers,82,70,70,222,74,0,2024-04-03
920,Thornhill,69,93,81,243,81,0,2024-04-04
921,Adamkiewicz,80,90,83,253,84,0,2024-04-03
922,Dracksford,71,78,51,200,66,0,2024-04-04
923,Inwood,73,58,74,205,68,0,2024-04-09
924,Leyland,72,86,68,226,75,0,2024-04-08
925,Acreman,68,90,74,232,77,0,2024-04-05
926,Bilbee,52,51,89,192,64,0,2024-04-09
927,Hapgood,84,61,77,222,74,0,2024-04-04
928,Daborne,54,55,58,167,55,0,2024-04-09
929,Farnworth,97,55,78,230,76,0,2024-04-02
930,Moffett,87,78,69,234,78,0,2024-04-04
931,Skyner,93,75,58,226,75,0,2024-04-08
932,Windrum,75,74,92,241,80,0,2024-04-05
933,Cadogan,69,96,89,254,84,0,2024-04-08
934,Gibbett,94,88,50,232,77,0,2024-04-03
935,McNirlan,72,93,76,241,80,0,2024-04-09
936,Lorentzen,59,91,78,228,76,0,2024-04-08
937,Mintoff,72,73,67,212,70,0,2024-04-03
938,Jozefczak,71,98,72,241,80,0,2024-04-06
939,Blockley,79,89,91,259,86,0,2024-04-05
940,Adds,61,54,97,212,70,0,2024-04-03
941,Blatcher,72,61,66,199,66,0,2024-04-09
942,Boughey,59,98,50,207,69,0,2024-04-09
943,Besson,91,96,96,283,94,0,2024-04-03
944,McNally,92,95,99,286,95,0,2024-04-06
945,Surtees,85,50,76,211,70,0,2024-04-01
946,Eatherton,54,59,55,168,56,0,2024-04-02
947,Dioniso,54,86,97,237,79,0,2024-04-07
948,Forcer,93,89,79,261,87,0,2024-04-02
949,Rangall,78,76,70,224,74,0,2024-04-01
950,Breach,91,55,75,221,73,0,2024-04-04
951,Lavell,79,70,76,225,75,0,2024-04-02
952,Silliman,51,67,87,205,68,0,2024-04-07
953,Devennie,86,68,68,222,74,0,2024-04-09
954,Utterson,66,78,77,221,73,0,2024-04-06
955,O' Loughran,60,74,87,221,73,0,2024-04-03
956,MacNally,92,53,87,232,77,0,2024-04-09
957,MacRorie,93,63,90,246,82,0,2024-04-08
958,Abrahamian,70,69,61,200,66,0,2024-04-02
959,Joberne,64,58,60,182,60,0,2024-04-09
960,Buard,64,77,51,192,64,0,2024-04-05
961,O'Henehan,88,71,52,211,70,0,2024-04-05
962,Vauter,62,55,61,178,59,0,2024-04-01
963,Rannells,69,55,82,206,68,0,2024-04-09
964,Kraut,61,96,72,229,76,0,2024-04-03
965,McDermott-Row,68,77,68,213,71,0,2024-04-07
966,O'Shevlin,94,70,62,226,75,0,2024-04-05
967,Miguet,79,86,68,233,77,0,2024-04-07
968,McGeown,83,69,72,224,74,0,2024-04-06
969,Aubin,82,80,98,260,86,0,2024-04-07
970,Hayter,91,76,66,233,77,0,2024-04-08
971,Housaman,59,86,51,196,65,0,2024-04-04
972,Frickey,73,95,76,244,81,0,2024-04-02
973,Cookley,87,51,74,212,70,0,2024-04-01
974,Carl,81,61,82,224,74,0,2024-04-04
975,Hallt,77,92,97,266,88,0,2024-04-01
976,Hawney,86,80,94,260,86,0,2024-04-09
977,Feifer,82,78,75,235,78,0,2024-04-03
978,Housecroft,59,97,63,219,73,0,2024-04-02
979,Hillborne,94,56,86,236,78,0,2024-04-02
980,Courtliff,59,69,90,218,72,0,2024-04-06
981,Chaplyn,99,72,57,228,76,0,2024-04-05
982,Jacqueme,69,77,57,203,67,0,2024-04-03
983,Ivons,97,63,57,217,72,0,2024-04-06
984,Stanton,67,54,80,201,67,0,2024-04-01
985,Aird,83,66,71,220,73,0,2024-04-05
986,Gutcher,60,93,70,223,74,0,2024-04-09
987,Tuffey,67,66,97,230,76,0,2024-04-04
988,Laurant,59,55,80,194,64,0,2024-04-08
989,Marston,78,96,61,235,78,0,2024-04-09
990,Garbott,95,70,91,256,85,0,2024-04-03
991,Poon,89,65,51,205,68,0,2024-04-08
992,Westhofer,95,99,70,264,88,0,2024-04-09
993,Scorey,61,98,66,225,75,0,2024-04-08
994,Domingues,76,98,52,226,75,0,2024-04-02
995,Laneham,54,72,55,181,60,0,2024-04-03
996,Winship,74,64,56,194,64,0,2024-04-02
997,Stebbings,74,97,95,266,88,0,2024-04-04
998,Pyburn,74,68,61,203,67,0,2024-04-05
999,Kaasmann,56,72,68,196,65,0,2024-04-01
1000,Brunelleschi,60,55,63,178,59,0,2024-04-03
